20
XXXOOOXXOOOOOXXOOXXO
XXXOOXXXXXXOOXXSOOOO
XXXXOOOOOOXXXXXXXXOO
XXXXOXXXXXOOOOOXXOOO
XXXOOOOOXXXXXOOOOOXO
XXXXOOXXXXOOOOXXXOXO
XXOOOOOOOOXOXXXXOOXO
OOOOFOOXOOOOOOOOOOOO
XXOOOOXOOXOXXXXOOOOO
OOOXXXXOXOOOXXXXOOOO
OOOXXXXOXOOOOOXXXXOO
OXOOOXXOOOXXXOOOXXOO
XXOOOXXXXOOOOOOOOOOO
OXOOXXOOOOOXXXOOOXOO
OOXXXOOOOOOOOOOOOOOO
OXXXOOOOXXXXOOOOOOOO
OOOOOXOOOOXOOXXOXOOO
OOXXXXXXOXXOOOXOOOOX
OOOOOOOXXXXOOOOOOXXO
OOOOOOOOOXXXXOOXXOOO
